1111111111
1000001C01
1E00100001
1111110011
1P0000C101
1111111111